80 80 80 80 80 80 80 80 84 0
80 80 80 84 80 80 80 84 0 0
82 80 84 0 82 80 84 0 0 0
0 11 0 0 0 11 0 0 0 0
0 11 0 0 0 11 0 0 0 0
0 11 0 0 0 11 0 0 0 0
10 10 10 10 10 10 10 10 10 10
20 20 20 20 20 20 20 20 20 20
30 30 30 30 30 30 30 30 30 30
40 40 40 40 40 40 40 40 40 40
									
									
									
									
									
									
									
									
									
									
									
									
									
									
									
									
									
									
									
									
