0 8 8 8	8 8 8 8 8 8
8 8 8 8	8 8 8 8	8 8
8 8 8 8	8 8 8 8	8 8
8 8 8 8	8 8 8 8	8 8
8 8 8 8	8 8 8 8	8 8
16 17 8 8 70 71 8 8 8 8
26 27 0 8 64 65 80 2 3 43
36 37 22 8 64 65 80 12 13 53
46 47 8 8 64 65 32 8 8 8
46 47 8 8 64 65 33 8 8 8
									
									
									
									
									
									
									
									
									
									
									
									
									
									
									
									
									
									
									
									
